EA ./textures/east_texture.xpm
WE ./textures/west_texture.xpm
NO ./textures/north_texture.xpm
SO ./textures/south_texture.xpm

C 255,16,14
F 150,80,900

11111111111
11000000011
11000000011
11000000011
11111111111