



EA ./textures/east_texture.xpm

WE                 ./textures/west_texture.xpm

NO       ./textures/north_texture.xpm      

C 99,77,88

SO ./textures/south_texture.xpm


F 99,55,33




 11111111111111111111111111111111 
 1E0000010000001             1
 10111010101111           1
 11101010100001           1
  11101011101101           1
 10000010001001           1
  10111110111001          1
       1 0 100000001001           1
   10101111111001           1
100000000000001           1
111111111111111111111111111











