



EA ./textures/east_texture.xpm

WE                 ./textures/west_texture.xpm

NO       ./textures/north_texture.xpm      

C 99,77,88

SO ./textures/south_texture.xpm


F 99,55,33





11111111111
11000000011
11S00000011
11000000011
11111111111
