

EA ./textures/east_texture.xpm

WE                 ./textures/west_texture.xpm

NO       ./textures/north_texture.xpm      

C 99,77,88

SO ./textures/south_texture.xpm


F 



11111
10N01



11111



