
      F 22 , 180,    250

  NO   ./textures/north_texture.xpm


C       102,  20, 3


  SO      ./textures/south_texture.xpm
  EA   ./textures/east_texture.xpm


  WE ./textures/wall.xpm



1111111
1000001
10000001
101N101
1011101
1000001
1111111
