EA ./textures/b_1.xpm
NO ./textures/b_3.xpm
WE ./textures/b_2.xpm
SO ./textures/b_4.xpm
F 0,0,0

C 0, 0,0

111111111111111111
1E0000000001000001
111111111001000001
100000000001000001
100000001001000001
100000001001000001
100000001101000001
100000001101111101
100000001000000001
100000001111011101
100000000000000101
111111111111111111
