EA ./textures/b_1.xpm
NO ./textures/b_3.xpm
WE ./textures/b_2.xpm
SO ./textures/b_4.xpm
F 0,0,0

C 0, 0,0

111111111111111111111111111111111111111111
1E0000000001000000000000000000000000000001
111111111001000000000000000000000000000101
100000000001000000000000000000000000000101
100000001001000000000000000000000000000101
100000001001000000000000000000000000000101
100000001101000000000000000000000000000101
100000001101111111000000000000000000000101
100000001000000001000000000000000000000101
100000001111011101111111111111111111111101
100000000000000100000000000000000000000001
111111111111111111111111111111111111111111
