
 EA ./textures/wall.xpm
 NO ./textures/wall.xpm

WE ./textures/wall.xpm

F 44 ,66, 8

SO ./textures/wall.xpm



   C 10,20,30

111111111111111111
1000E0000001000001
111111111001000001
100000000001000001
100101001001000001
100010001001000001
100000000000000101
111111111111111111



